-23
26
-11
12
00000000000000000000000000000000000000000000000000
00000000000000000000000000000000000000000000000000
01111111111111111110001111111111111111111111111110
01000000000000000000000000000000000000000000000010
01001111100000000000000000000000000000000000000010
01001111100000011000000000000110000000000000000010
01111001111000011000000000000110000000000000000010
01111111111000000000000000000000000000000000000010
01000000000000000000000000000000000000000000000010
01000000000000000000000000000000000000000000000010
01000000000000000000000000000000000000000000000000
01000000000000000000000000000000000000000000000000
00000000000000000000000000000000000000000000000000
00000000000000000000000000000000000000000000000010
00000000000000000000000000000000000000000000000010
01000000000000000000000000000000000000000000000010
01000000000000000000000000000000000000000000000010
01000000000000000000000000000000000000000000000010
01000000000000000000000000000000011000000000000010
01000000000000000000000000000000011000000000000010
01000000000000000000000000000000000000000000000010
01000000000000000000000000000000000000000000000010
01000000000000000000000000000000000000000000000010
01111111111111111111111111111111111111111111111110
